111111111111111111111111111111111111111111
11111N000011111111110000N00000000000000001
110111110000001111111111111111111101111111
1101110001000000100000000000000000001N0001
1100000011000000100000C0001000000000100001
111100001C000100000000000011111110000000C1
111100011111111111111111001100000000100001
111110000C00000001111111P01N00000000100001
110111110000000000011111001111111000111111
110111100000000000000000000000000000000001
110000000000000000000000000000000000000001
110000000000011110010000000000000111000001
11011000011111111111000000000C000001000001
110100000100CN0000000000000011100000000001
111110000000000000000000001111111100000001
111111000000001100000000001110001100000001
11011000000000110000000001100000011100E001
110100000000000000111001111000000110000001
111111111111111111111111111111111111111111
